filename, language, Django txt, Java, comment, blank, total
app\App.java, Java, 0, 22, 38, 4, 64
arquivos\registrosAlunos.txt, Django txt, 1, 0, 0, 1, 2
arquivos\registrosCursos.txt, Django txt, 1, 0, 0, 1, 2
assistenciaestudantil\Bolsa.java, Java, 0, 24, 13, 9, 46
assistenciaestudantil\BolsaVigente.java, Java, 0, 23, 6, 8, 37
assistenciaestudantil\GerenciadorBolsas.java, Java, 0, 77, 5, 14, 96
complementares\ContaBancaria.java, Java, 0, 42, 23, 14, 79
complementares\Endereco.java, Java, 0, 59, 27, 16, 102
complementares\Utilitario.java, Java, 0, 238, 0, 19, 257
contratos\Armazenavel.java, Java, 0, 5, 0, 3, 8
contratos\ClassesGeral.java, Java, 0, 4, 0, 4, 8
contratos\OperacoesBasicas.java, Java, 0, 6, 0, 3, 9
ensino\classecurso\Curso.java, Java, 0, 51, 12, 14, 77
ensino\classecurso\GerenciadorCursos.java, Java, 0, 126, 1, 21, 148
ensino\secaodisciplina\Disciplina.java, Java, 0, 42, 18, 12, 72
ensino\secaodisciplina\DisciplinaAplicada.java, Java, 0, 49, 18, 14, 81
ensino\secaodisciplina\DisciplinaConcluida.java, Java, 0, 9, 0, 5, 14
excecoes\ItemNaoEncontrado.java, Java, 0, 7, 0, 3, 10
excecoes\OperacaoNaoAutorizada.java, Java, 0, 7, 0, 3, 10
interfacegrafica\AcaoCadastrarAluno.java, Java, 0, 327, 40, 9, 376
interfacegrafica\AcaoCadastrarCurso.java, Java, 0, 74, 3, 11, 88
interfacegrafica\AcaoExcluirAluno.java, Java, 0, 32, 0, 7, 39
interfacegrafica\AcaoExcluirCurso.java, Java, 0, 38, 0, 7, 45
interfacegrafica\AcaoPesquisarAluno.java, Java, 0, 25, 0, 7, 32
interfacegrafica\AcaoPesquisarCurso.java, Java, 0, 24, 0, 7, 31
interfacegrafica\CadastroAluno.java, Java, 0, 248, 29, 16, 293
interfacegrafica\CadastroCurso.java, Java, 0, 73, 0, 12, 85
interfacegrafica\ClicouBotaoPesquisaAluno.java, Java, 0, 27, 0, 9, 36
interfacegrafica\ClicouBotaoPesquisaCurso.java, Java, 0, 24, 0, 9, 33
interfacegrafica\ClicouCadastrarAlterarAlunoButton.java, Java, 0, 33, 3, 9, 45
interfacegrafica\ClicouCadastrarAlterarCursoButton.java, Java, 0, 23, 8, 7, 38
interfacegrafica\ClicouCelulaAluno.java, Java, 0, 35, 4, 9, 48
interfacegrafica\ClicouCelulaCurso.java, Java, 0, 37, 4, 9, 50
interfacegrafica\HubPrincipal.java, Java, 0, 26, 0, 11, 37
interfacegrafica\JanelaPrincipal.java, Java, 0, 166, 155, 67, 388
interfacegrafica\PainelOpcoesAluno.java, Java, 0, 28, 1, 9, 38
interfacegrafica\PainelOpcoesCurso.java, Java, 0, 29, 0, 16, 45
interfacegrafica\PesquisaAluno.java, Java, 0, 60, 4, 11, 75
interfacegrafica\PesquisaCurso.java, Java, 0, 56, 4, 13, 73
interfacegrafica\TrocaTela.java, Java, 0, 17, 0, 7, 24
pessoas\classealuno\Aluno.java, Java, 0, 230, 28, 32, 290
pessoas\classealuno\GerenciadorAluno.java, Java, 0, 151, 0, 23, 174
pessoas\superclasse\PessoaFisica.java, Java, 0, 131, 49, 29, 209
sistema\classes\ServidorArmazenamento.java, Java, 0, 13, 5, 8, 26
sistema\classes\Usuario.java, Java, 0, 6, 0, 4, 10
Total, -, 2, 2724, 498, 526, 3750