filename, language, Django txt, Java, comment, blank, total
app\App.java, Java, 0, 14, 44, 4, 62
arquivos\registrosAlunos.txt, Django txt, 1, 0, 0, 1, 2
arquivos\registrosCursos.txt, Django txt, 1, 0, 0, 1, 2
arquivos\registrosProfessores.txt, Django txt, 0, 0, 0, 1, 1
assistenciaestudantil\Bolsa.java, Java, 0, 24, 13, 9, 46
assistenciaestudantil\BolsaVigente.java, Java, 0, 23, 6, 8, 37
assistenciaestudantil\GerenciadorBolsas.java, Java, 0, 77, 5, 14, 96
complementares\ContaBancaria.java, Java, 0, 42, 23, 14, 79
complementares\Endereco.java, Java, 0, 59, 27, 16, 102
complementares\Utilitario.java, Java, 0, 238, 0, 19, 257
contratos\Armazenavel.java, Java, 0, 5, 0, 3, 8
contratos\ClassesGeral.java, Java, 0, 4, 0, 4, 8
contratos\OperacoesBasicas.java, Java, 0, 6, 0, 3, 9
ensino\classecurso\Curso.java, Java, 0, 60, 15, 17, 92
ensino\classecurso\GerenciadorCursos.java, Java, 0, 126, 1, 21, 148
ensino\departamento\Departamento.java, Java, 0, 15, 1, 6, 22
ensino\secaodisciplina\Boletim.java, Java, 0, 29, 9, 9, 47
ensino\secaodisciplina\Disciplina.java, Java, 0, 41, 18, 14, 73
ensino\secaodisciplina\DisciplinaAplicada.java, Java, 0, 49, 18, 14, 81
ensino\secaodisciplina\DisciplinaConcluida.java, Java, 0, 9, 0, 5, 14
ensino\secaodisciplina\GerenciadorDisciplinas.java, Java, 0, 20, 0, 7, 27
excecoes\ItemNaoEncontrado.java, Java, 0, 7, 0, 3, 10
excecoes\OperacaoNaoAutorizada.java, Java, 0, 7, 0, 3, 10
interfacegrafica\AcaoCadastrarAluno.java, Java, 0, 327, 40, 9, 376
interfacegrafica\AcaoCadastrarCurso.java, Java, 0, 74, 3, 11, 88
interfacegrafica\AcaoCadastrarProfessor.java, Java, 0, 318, 7, 9, 334
interfacegrafica\AcaoExcluirAluno.java, Java, 0, 32, 0, 7, 39
interfacegrafica\AcaoExcluirCurso.java, Java, 0, 36, 0, 7, 43
interfacegrafica\AcaoExcluirProfessor.java, Java, 0, 32, 0, 7, 39
interfacegrafica\AcaoPesquisarAluno.java, Java, 0, 25, 0, 7, 32
interfacegrafica\AcaoPesquisarCurso.java, Java, 0, 24, 0, 7, 31
interfacegrafica\AcaoPesquisarProfessor.java, Java, 0, 24, 0, 7, 31
interfacegrafica\CadastroAluno.java, Java, 0, 248, 29, 16, 293
interfacegrafica\CadastroCurso.java, Java, 0, 73, 0, 12, 85
interfacegrafica\CadastroDisciplina.java, Java, 0, 1, 0, 0, 1
interfacegrafica\CadastroProfessor.java, Java, 0, 237, 27, 17, 281
interfacegrafica\ClicouBotaoPesquisaAluno.java, Java, 0, 27, 0, 9, 36
interfacegrafica\ClicouBotaoPesquisaCurso.java, Java, 0, 24, 0, 9, 33
interfacegrafica\ClicouBotaoPesquisaProfessor.java, Java, 0, 24, 0, 9, 33
interfacegrafica\ClicouCadastrarAlterarAlunoButton.java, Java, 0, 33, 3, 9, 45
interfacegrafica\ClicouCadastrarAlterarCursoButton.java, Java, 0, 23, 8, 7, 38
interfacegrafica\ClicouCadastrarAlterarProfessorButton.java, Java, 0, 28, 6, 7, 41
interfacegrafica\ClicouCelulaAluno.java, Java, 0, 35, 4, 9, 48
interfacegrafica\ClicouCelulaCurso.java, Java, 0, 35, 4, 9, 48
interfacegrafica\ClicouCelulaProfessor.java, Java, 0, 35, 4, 9, 48
interfacegrafica\HubPrincipal.java, Java, 0, 31, 0, 11, 42
interfacegrafica\JanelaPrincipal.java, Java, 0, 175, 155, 68, 398
interfacegrafica\PainelOpcoesAluno.java, Java, 0, 28, 1, 9, 38
interfacegrafica\PainelOpcoesCurso.java, Java, 0, 28, 0, 15, 43
interfacegrafica\PainelOpcoesProfessor.java, Java, 0, 28, 2, 11, 41
interfacegrafica\PesquisaAluno.java, Java, 0, 60, 4, 11, 75
interfacegrafica\PesquisaCurso.java, Java, 0, 54, 4, 13, 71
interfacegrafica\PesquisaProfessor.java, Java, 0, 54, 4, 12, 70
interfacegrafica\TrocaTela.java, Java, 0, 17, 0, 7, 24
pessoas\classealuno\Aluno.java, Java, 0, 229, 28, 32, 289
pessoas\classealuno\GerenciadorAluno.java, Java, 0, 151, 0, 23, 174
pessoas\classeprofessor\GerenciadorProfessor.java, Java, 0, 105, 0, 19, 124
pessoas\classeprofessor\Professor.java, Java, 0, 159, 6, 22, 187
pessoas\superclasse\PessoaFisica.java, Java, 0, 131, 49, 29, 209
sistema\classes\ServidorArmazenamento.java, Java, 0, 16, 5, 8, 29
sistema\classes\Usuario.java, Java, 0, 6, 0, 4, 10
Total, -, 2, 3842, 573, 683, 5100